5 5
3 1
+ + + + M
+ + - + +
+ + ! + +
+ - - + +
@ - $ + +
 